i i i i i i i i i i i i i i i i i i i i i i i i i i i i
i i i i i i i i i i i i i i i i i i i i i i i i i i i i
i i i i i i i i i i i i i i i i i i i i i i i i i i i i
i i i v v v v v v v v v v v v v v v v v v v v v v i i i
i i i v i i i i i i i i i i i v i i i i i i i i v i i i
i i i v i i i i i i i i i i i v i i i i i i i i v i i i
i i i v i i v v v i v v v i v v v i v v v i i i v i i i
i i i v i i v v v v v v v i v v v i v v v i i i v i i i
i i i v i i v v v i v v v i v v v i v v v i i i v i i i
i i i v i i i i i i i v i i i v i i i v i i i i v i i i
i i i v i i v v v i i v i i i v i i i v i v v i v i i i
i i i v v v v v v v v v v v v v v v v v v v v i v i i i
i i i v i i v v v i i v i i i i i i i v i v v i v i i i
i i i v i i i v i i i v i i i i i i i v i i i i v i i i
i i i v i i v v v i v v v i v v v i v v v i i i v i i i
i i i v i i v v v i v v v v v v v i v v v i i i v i i i
i i i v i i v v v i v v v i v v v i v v v i i i v i i i
i i i v i i i v i i i i i i i v i i i i i i i i v i i i
i i i v i i v v v i i i i v v v v v i i v v v i v i i i
i i i v i i v v v i i i i v v vp3 v v i i v v v i v i i i
i i i v i i i i i i i i i i i i i i i i i v i i v i i i
i i i v v v v v v v v v v v v v v v v v v v v v v i i i
i i i i i i v i i i i i i i v i i i i i i v i i i i i i
i i i i i i v i i i i i i i v i i i i i i v i i i i i i
i i i i v v v v v i i i v v v v v i i v v v v v i i i i
i i i i v v v v v i i i v v vd v v i i v v v v v i i i i
i i i i v v v v v i i i v v v v v i i v v v v v i i i i
i i i i i i i i i i i i i i i i i i i i i i i i i i i i