i i i i i i i i i i i i i i i i i i i i i i i i i i i i
i i v v v v v i i i i i v v v i i i i i i i i i i i i i
i i v v v v v v v v i i v vp2 v i i i v v v v i i i i i i
i i v v v v v i i v i i v v v i i i i i i v i i i i i i
i i i i v i i i i v i i i v i i i i i i i v i v v v v i
i i i i v i i i i v v v v v v v v v v i i v v v v v v i
i i i i v i i i i i i i i v i i i i v i i i i v v v v i
i i v v v v v i i i i i i i i i i i v i i i i v v v v i
i i v v v v v v v v v v v v v v v v v i i i i i i v i i
i i v v v v v i i i i i i i i i i i i i i i i i i v i i
i i i i v i i i i i i i i i v v v v v v v v i i i v i i
i i i i v i i i i i i i i i v v v v v v v v i i i v i i
i i i i v i i v v v v v i i v v v v v v v v i i i v i i
i i v v v v v v v v v v v v v i i i v i i i i i i v i i
i i i i i i i v v v v v i i i i i i v i i i i i i v i i
i i i i v i i i i v i i i i i i v v v v v i i i i v i i
i i i i v i i i i v i i i i i i v v v v v v v v v v i i
i i i i v i i i i v v v v v i i v v v v v i i i i v i i
i i v v v v i i i v i i i v i i i i v i i i i i i v i i
i i v i i v i i i v i i i v i i i i v i i i i i i v i i
i i v i i v i i v v v v v v v v v v v v v v v v v v i i
i i v i i i i i i i i i i i i i i i v i i i i v i i i i
i i v v v v v v i i v v v v v v v v v v v v i v i i i i
i i v i i v v v i i v i i v i i i i v i i i i v i i i i
i i v i i v v v i i v i i v i i i i v i i v v v v v i i
i i v i i v v v v v v i v vd v i i i v v v v v v v v i i
i i i i i i i i i i i i v v v i i i i i i i i i i i i i
i i i i i i i i i i i i i i i i i i i i i i i i i i i i