i i i i i i i i i i i i i i i i i i i i i i i i i i i i
i v v v i i i i i i i i i i i i i i i i i v v v i i i i
i v v v i i i i i i i i v v v i i i i i i v v v i i i i
i i v i i i i v v v v v v vp1 v i i i i i i v v v i i i i
i i v i i i i v i i i i v v v i i i i i i i v i i i i i
i i v v v v v v i i i i i i i i i i i i i i v i i i i i
i i v i i i i i i i i i i i i i i i i i i i v i i i i i
i i v i i i i i i i i i i i i i i i i v v v v v v v i i
i i v i i i i i i i i v v v v v i i i v v v v v v v i i
i i v v v v v v i i i v v v v v i i i v v v v v v v i i
i i i v i i i v i i i v v v v v i i i v v v v v v v i i
i i i v i i i v i i i i i v i i i i i i i i v i i i i i
i i v v v i i v i i i i i v i i i i i i i i v i i i i i
i i v v v i i v i i i i i v i i i i i i v v v v v i i i
i i v v v i i v i i i i i v i i i i i i v i i i v i i i
i i i i i i i v v v v v v v v v v v v v v i i i v i i i
i i i i i i i v i i i i i i i i i i i i v i i i v i i i
i i i i i i i v i i i i i i i i i i i i v i i i v i i i
i i v v v i i v i i v v v i i i i i v v v v i i v i i i
i i v v v v v v v v v v v i i i i i v v v v i i v i i i
i i v v v i i v i i v v v i i i i i v v v v i i v i i i
i i i i i i i v i i i i i i i i i i i i i i i i v i i i
i i i i i i i v i i i i i i v v v v v v v v v v v i i i
i i i i i i v v v v i i i i v i i i i i i i i i i i i i
i i i i i i v v v v i i i i v i i i i i i i i i i i i i
i i i i i i v v v v i i v v v v v i i i i i i i i i i i
i i i i i i i i i i i i v v vd v v i i i i i i i i i i i
i i i i i i i i i i i i i i i i i i i i i i i i i i i i